.................
.................
.................
.................
.................
.................
.................
.................
..O..............
.................
...........X.....
...........XXXXX.
............XXXX.
............XXXX.
.................
