xx.X.............
OOXX.............
OOOX.............
OOOX.............
..OXXXX..........
OOOOOOXX.........
OOOO.XXXX........
OOOO.OXXX........
.OOOOO.XXX.......
..OOO..XXX.......
.......XXXXX.....
...........XX....
............XXX..
.................
.................
-----
xx.X.............
OOXX.............
OOOX.............
OOOX.............
..OXXXX..........
OOOOOOXX.........
OOOO.XXXX........
OOOO.OXXX........
.OOOOO.XXX.......
..OOO..XXX.......
.......XXXXX.....
...........XX....
............XXX..
.................
.................
-----
xx.X.............
OOXX.............
OOOX.............
OOOX.............
..OXXXX..........
OOOOOOXX.........
OOOO.XXXX........
OOOO.OXXX........
.OOOOO.XXX.......
..OOO..XXX.......
.......XXXXX.....
...........XX....
............XXX..
.................
.................
-----
xx.X.............
OOXX.............
OOOX.............
OOOX.............
..OXXXX..........
OOOOOOXX.........
OOOO.XXXX........
OOOO.OXXX........
.OOOOO.XXX.......
..OOO..XXX.......
.......XXXXX.....
...........XX....
............XXX..
.................
.................
-----
xx.X.............
OOXX.............
OOOX.............
OOOX.............
..OXXXX..........
OOOOOOXX.........
OOOO.XXXX........
OOOO.OXXX........
.OOOOO.XXX.......
..OOO..XXX.......
.......XXXXX.....
...........XX....
............XXX..
.................
.................
-----
xx.X.............
OOXX.............
OOOX.............
OOOX.............
..OXXXX..........
OOOOOOXX.........
OOOO.XXXX........
OOOO.OXXX........
.OOOOO.XXX.......
..OOO..XXX.......
.......XXXXX.....
...........XX....
............XXX..
.................
.................
-----
xx.X.............
OOXX.............
OOOX.............
OOOX.............
..OXXXX..........
OOOOOOXX.........
OOOO.XXXX........
OOOO.OXXX........
.OOOOO.XXX.......
..OOO..XXX.......
.......XXXXX.....
...........XX....
............XXX..
.................
.................
-----
xx.X.............
OOXX.............
OOOX.............
OOOX.............
..OXXXX..........
OOOOOOXX.........
OOOO.XXXX........
OOOO.OXXX........
.OOOOO.XXX.......
..OOO..XXX.......
.......XXXXX.....
...........XX....
............XXX..
.................
.................
-----
